000000000000000
011020202020110
010002020200010
000000000000000
020000000000020
002000000000200
020000000000020
002000000000200
020000000000020
000000000000000
010002020200010
011020202020110
000000000000000