000000000000000
000110222011000
001000000000100
001000020000100
000000202000000
002002000200200
002020000020200
002002000200200
000000202000000
001000020000100
001000000000100
000110222011000
000000000000000