000000000000000
000100000000000
000000000000000
000003000000000
000000000000000
000000000001000
000000000000000
000000000200000
000000000000000
000200010000030
000000000000000
010203000000000
000000000000000